###########
#eooo--ooo#
#--- --=oo#
#- - -----#
#- ----=--#
#- -------#
#---E===--#
###########